A = I
B = J
C = K
D = L
E = M
F = N
G = O
H = P
I = Q
J = R
K = S
L = T
M = U
N = V
O = W
P = X
Q = Y
R = Z
S = A
T = B
U = C
V = D
W = E
X = F
Y = G
Z = H
8
S ESF XDQAFY AF S ZGL SAJ TSDDGGF KMVVWFDQ JWSDARWK ZW'K DGKL. ZW JWVMUWK ZWAYZL SFV KHGLK S ESF VGOF TWDGO. ZW DGOWJK LZW TSDDGGF XMJLZWJ SFV KZGMLK LG YWL VAJWULAGFK,"WPUMKW EW, USF QGM LWDD EW OZWJW A SE?"
LZW ESF TWDGO KSQK: "QWK. QGM'JW AF S ZGL SAJ TSDDGGF, ZGNWJAFY 30 XWWL STGNW LZW YJGMFV."
"QGM EMKL OGJC AF AFXGJESLAGF LWUZFGDGYQ" KSQK LZW TSDDGGFAKL.
"A VG," JWHDAWK LZW ESF. "ZGO VAV QGM CFGO?"
"OWDD," KSQK LZW TSDDGGFAKL, "WNWJQLZAFY QGM ZSNW LGDV EW AK LWUZFAUSDDQ UGJJWUL TML AL'K GX FG MKW LG SFGQGFW."
LZW ESF TWDGO JWHDAWK, "QGM EMKL OGJC AF ESFSYWEWFL."
"A VG," JWHDAWK LZW TSDDGGFAKL, "TML ZGO'V QGM CFGO?"
"OWDD," KSQK LZW ESF, "QGM VGF'L CFGO OZWJW QGM SJW GJ OZWJW QGM'JW YGAFY, TML QGM WPHWUL EW LG ZWDH. QGM'JW AF LZW KSEW HGKALAGF QGM OWJW TWXGJW OW EWL, TML FG AL'K EQ XSMDL."
